######################################################
#----------------------------------------------------#
#-###    ###-############################-##-#######-#
#-###    ###-############################-##-#######-#
#-###    ###----*-------------------------##---------#
#-##########-#####-################-#####-##-#######-#
#-##########-#####------------------#####-##-#######-#
#---------------##-####-######-####-##---------------#
#-###-######-##-##-####-######-####-##-######-######-#
#-###-######-----------------------------------------#
#-###-######-#-#-#-######-##########-##-######-#####-#
#------------#-#-#-------------------##-######-#####-#
#-###-######-#-#-#-######-##########-##-######-#####-#
#-###-######-#-#-#-######-##########-----------#####-#
-------------------------------------#-#-#-###--------
#-##########-#-#-#-######-#-########-#-#-#-----#####-#
#------------#-#-#--------#----------#-#-#-###-#####-#
#-#-##-##-##-#-#-#-######-#-########-#-#-#-###-#####-#
#-#-##-##-##-#-#-#-######-#----------#-#-#-----------#
#-#-##-##-##-#-#-#-######-#-########-#-#-#-###-#####-#
#-#-##-##-##-#-----------------------------###-#####-#
#-#-##-##-##-##-##-####-######-####-##-###-###-#####-#
#---------------##-####-######-####-##---------------#
#-#-##-##-##-#####------------------#####-###    ###-#
#-#-##-##-##-#####-################-#####-###    ###-#
#-#-##-##-##------------------------------###    ###-#
#-#-##-##-##-############################-##########-#
#------------############################-##########-#
#-##########-----------------------------------------#
######################################################
