######################################################
#----------------------------------------------------#
#-##      ##-############################-##-#######-#
#-##      ##-############################-##-#######-#
#-##      ##------------------------------##---------#
#-##########-#####-################-####--##-#######-#
#-##########-#####------------------####--##-#######-#
#---------------##-####-######-####-##---------------#
#--##-######-##-##-####-######-####-##-######-######-#
#--##-######-----------------------------------------#
#--##-######-#-#-#-######-##########-##-######-####--#
#------------#-#-#-------------------##-######-####--#
#--##-######-#-#-#-######-##########-##-######-####--#
#--##-######-#-#-#-######-##########-----------####--#
-------------------------------------#-#-#-###--------
#-##########-#-#-#-######-#-########-#-#-#-----####--#
#------------#-#-#--------#----------#-#-#-###-####--#
#-#-##-##-##-#-#-#-######-#-########-#-#-#-###-####--#
#-#-##-##-##-#-#-#-######-#----------#-#-#-----------#
#-#-##-##-##-#-#-#-######-#-########-#-#-#-###-####--#
#-#-##-##-##-------------------------------###-####--#
#-#-##-##-##----##-####-######-####-##-###-###-####--#
#---------------##-####-######-####-##---------------#
#-#-##-##-##--####------------------#####-##      ##-#
#-#-##-##-##--####-################-#####-##      ##-#
#-#-##-##-##------------------------------##      ##-#
#-#-##-##-##-############################-##########-#
#------------############################-##########-#
#-##########-----------------------------------------#
######################################################
