######################################################
#----------------------------------------------------#
#-####  ####-############################------------#
#-####  ####-############################------------#
#-##      ##---------------------------------- ------#
#-##########--####-################-####-------------#
#-##########--####------------------####-------------#
#---------------##-####-######-####-##---------------#
#---------------##-####-######-####-##---------------#
#----------------------------------------------------#
#----------------------------------------------------#
#----------------------------------------------------#
#----------------------------------------------------#
#----------------------------------------------------#
------------------------------------------------------
#----------------------------------------------------#
#----------------------------------------------------#
#----------------------------------------------------#
#----------------------------------------------------#
#----------------------------------------------------#
#----------------------------------------------------#
#---------------##-####-######-####-##---------------#
#---------------##-####-######-####-##---------------#
#-------------####------------------####--####  ####-#
#-------------####-################-####--####  ####-#
#----- -----------------------------------##      ##-#
#------------############################-##########-#
#------------############################-##########-#
#----------------------------------------------------#
######################################################