######################################################
#----------------------------------------------------#
#-##      ##-############################-##-#######-#
#-##      ##-############################-##-#######-#
#-##      ##----*-------------------------##---------#
#-##########-#####-################-####--##-#######-#
#-##########-#####------------------####--##-#######-#
#---------------##-####-######-####-##---------------#
#-###-######-##-##-####-######-####-##-######-######-#
#-###-######-----------------------------------------#
#-###-######-#-#-#-######-##########-##-######-#####-#
#------------#-#-#-------------------##-######-#####-#
#-###-######-#-#-#-######-##########-##-######-#####-#
#-###-######-#-#-#-######-##########-----------#####-#
-------------------------------------#-#-#-###--------
#-##########-#-#-#-######-#-########-#-#-#-----#####-#
#------------#-#-#--------#----------#-#-#-###-#####-#
#-#-##-##-##-#-#-#-######-#-########-#-#-#-###-#####-#
#-#-##-##-##-#-#-#-######-#----------#-#-#-----------#
#-#-##-##-##-#-#-#-######-#-########-#-#-#-###-#####-#
#-#-##-##-##-#-----------------------------###-#####-#
#-#-##-##-##-##-##-####-######-####-##-###-###-#####-#
#---------------##-####-######-####-##---------------#
#-#-##-##-##-#####------------------#####-##      ##-#
#-#-##-##-##-#####-################-#####-##      ##-#
#-#-##-##-##------------------------------##      ##-#
#-#-##-##-##-############################-##########-#
#------------############################-##########-#
#-##########-----------------------------------------#
######################################################
