######################################################
#----------------------------------------------------#
#-##########-############################-##-#######-#
#-##########-############################-##-#######-#
#---------------*-------------------------##---------#
#-##########-#####-################-####--##-#######-#
#-##########-#####------------------####--##-#######-#
#---------------##-####-######-####-##---------------#
#-###-######-##-##-####-######-####-##-######-######-#
#-###-######-----------------------------------------#
#-###-######-#-#-#-######-##########-##-######-#####-#
#------------#-#-#-------------------##-######-#####-#
#-###-######-#-#-#-######-##########-##-######-#####-#
#-###-######-#-#-#-######-##########-----------#####-#
-------------------------------------#-#-#-###--------
#-##########-#-#-#-######-#-########-#-#-#-----#####-#
#------------#-#-#--------#----------#-#-#-###-#####-#
#-#-##-##-##-#-#-#-######-#-########-#-#-#-###-#####-#
#-#-##-##-##-#-#-#-######-#----------#-#-#-----------#
#-#-##-##-##-#-#-#-######-#-########-#-#-#-###-#####-#
#-#-##-##-##-#-----------------------------###-#####-#
#-#-##-##-##-##-##-####-######-####-##-###-###-#####-#
#---------------##-####-######-####-##---------------#
#-#-##-##-##-#####------------------#####-##########-#
#-#-##-##-##-#####-################-#####-##########-#
#-#-##-##-##-----------------------------------------#
#-#-##-##-##-############################-##########-#
#------------############################-##########-#
############-----------------------------------------#
######################################################
