######################################################
#----------------------------------------------------#
#-##########-############################-##-#######-#
#-##########-############################-##-#######-#
#---------------*-------------------------##---------#
#-##########-#####-################-#####-##-#######-#
#-##########-#####------------------#####-##-#######-#
#---------------##-####-######-####-##---------------#
#-###-######-##-##-####-######-####-##-######-######-#
#-###-######-----------------------------------------#
#-###-######-#-#-#-######-##########-##-######-#####-#
#------------#-#-#-------------------##-######-#####-#
#-###-######-#-#-#-######-##########-##-######-#####-#
#-###-######-#-#-#-######-##########-##-######-#####-#
------------------------------------------------------
#-#####-######-##-##########-######-#-#-#-######-###-#
#-#####-######-##-##########-######-#-#-#-######-###-#
#-#####-######-##-------------------#-#-#------------#
#-#####-######-##-##########-######-#-#-#-######-###-#
#-----------------------------------------######-###-#
#-######-######-##-####-######-####-##-##-######-###-#
#---------------##-####-######-####-##---------------#
#-#######-##-#####------------------#####-##########-#
#-#######-##-#####-################-#####-##########-#
#---------##-------------------------*---------------#
#-#######-##-############################-##########-#
#-#######-##-############################-##########-#
#----------------------------------------------------#
######################################################